##############
#211113111112#
#1####1#####1#
#1####1#####1#
#1####1#####1#
#3111141131131
#1####1##1####
#1####1##1####
#211113##2112#
######1#####1#
/////#1#####1#
/////#1##21131
/////#1##1####
######1##1#000
1111114113#000
######1##1#000
/////#1##1####
/////#1##31111
/////#1##1####
######1##1####
#211114113112#
#1####1#####1#
#1####1#####1#
#212##31131131
###1##1##1####
###1##1##1####
#213112##2112#
#1##########1#
#1##########1#
#2111111111131
##############
