19,21,30,4
###################
#........#........#
#@##.###.#.###.##@#
#.................#
#.##.#.#####.#.##.#
#....#...#...#....#
####.###0#0###.####
///#.#0000000#.#///
####.#0#####0#.####
0000.00#000#00.0000
####.#0#####0#.####
///#.#0000000#.#///
####.#0#####0#.####
#........#........#
#.##.###.#.###.##.#
#@.#...........#.@#
##.#.#.#####.#.#.##
#....#...#...#....#
#.######.#.######.#
#.................#
###################
