###################/
#21131112#21113112#/
#1##.###1#1###1##1#/
#31141313131314113#/
#1##1#1#####1#1##1#/
#2113#212#212#3112#/
####1###1#1###1####/
///#1#2131312#1#////
####1#1#####1#1#####
1111413#000#31411111
####1#1#####1#1#####
///#1#2111112#1#////
####1#1#####0#1####/
#21141312#21314112#/
#1##1###1#1###1##1#/
#22#31313131313#22#/
##1#1#1#####1#1#1##/
#2312#212#212#2132#/
#1######1#1######1#/
#21111113131111112#/
###################/